Achlys: goddess of the Eternal Night
Aether: god of the Spark of Life
Aion: god of Eternity
Ananke: goddess of Inevitability, Compulsion, and Necessity
Aphrodite: goddess of Love
Apollo: god of the Sun, Music and Poetry
Ares: god of War
Artemis: goddess of the Hunt
Athena: goddess of Strategy
Chaos: god of the Void
Chronos: god of Time
Coeus: god of Intellect
Crius: god of the Constellations
Cronus: god of the Harvest
Demeter: goddess of Harvest
Dionysus: god of Wine
Erebus: god of Darkness and Shadow
Eros: god of Love and Procreation
Gaia: goddess of the Mother Earth
Hades: god of the Underworld
Hemera: goddess of Day
Hephaestus: god of Fire
Hera: goddess of Marraige
Hera: goddess of Women
Hermes: Messenger God
Hyperion: god of Light
Hypnos: god of Sleep
Iapetus: god of Mortal Life
Mnemosyne: goddess of Memory
Nemesis: goddess of Retribution
Nesoi: goddesses of Islands
Nyxgoddess of Night
Oceanus: god of the Oceans
Ourea: god of Mountains
Phoebe: goddess of Prophecy
Pontus: father of the Sea Creatures
Poseidon: god of the Sea
Rhea: goddess of Fertility
Tartarus: god of the Darkest Places
Tethys: goddess of the Rivers
Thalassa: consort of god Pontus
Thanatos: god of Death
Theia: goddess of the aether
Themis: goddess of Law and Order
Uranus: god of the Heavens
Zeus: god of the Sky